20
1 0 0 4 0 0 0 0 0 0 0 3 0 2 4 0 0 0 0 0
0 3 0 4 0 0 0 0 0 0 0 3 0 0 4 0 0 5 0 0
0 3 0 0 5 6 0 0 0 0 0 4 3 5 4 4 4 3 6 5
0 0 0 3 0 6 6 0 0 0 0 0 0 0 4 0 0 0 0 0
5 0 0 3 0 0 0 0 0 0 0 0 0 0 4 0 0 0 0 0
5 5 0 0 0 0 0 0 0 0 0 0 0 0 4 0 0 0 0 0
0 3 3 3 0 0 0 0 0 0 0 0 0 0 4 0 0 0 0 0
0 0 0 4 0 0 0 0 3 3 3 0 0 0 4 0 0 0 0 0
0 0 0 4 0 0 0 0 0 0 4 0 0 0 4 0 0 0 0 0
0 0 0 3 0 0 0 0 0 0 4 0 0 0 3 0 0 0 0 0
0 0 0 3 3 3 4 6 3 0 3 6 6 5 3 0 0 0 0 0
0 0 0 5 0 0 0 0 4 0 0 0 0 0 3 0 0 0 0 0
4 3 3 3 0 0 0 0 4 0 0 0 0 0 4 0 0 0 0 0
0 0 0 0 0 0 0 0 3 0 0 0 0 0 4 0 0 0 0 0
0 0 0 0 0 0 0 0 5 5 5 0 0 0 4 5 3 3 4 6
0 0 0 0 0 0 0 0 0 5 5 0 0 0 4 3 0 0 0 0
4 6 6 3 3 0 0 0 3 0 0 0 0 0 4 0 0 0 0 0
0 0 0 0 3 0 0 3 3 3 3 4 3 5 4 0 0 0 2 0
0 0 0 0 4 0 0 4 0 0 0 0 0 0 4 0 0 0 0 0
2 0 0 0 5 0 0 6 0 2 0 5 0 0 4 0 0 0 0 0